#################
#..............##
#..............##
#..............##
#..............##
#..............##
#........#.....##
#...#...#......##
#....###.......##
#..............##
#..............##
#################
