################################################################################################################################################################
#########################################55555555555555555555555555555555555555#################################################################################
#########################################55555555555555555555555555555555555555#################################################################################
#########################################55555555555555555555555555555555555555#################################################################################
#########################################55555555555555555555555555555555555555#################################################################################
#########################################55555555555555555555555555555555555555#################################################################################
#########################################55555555555555555555555555555555555555#################################################################################
#########################################55555555555555555555555555555555555555#################################################################################
#########################################55555555555555555555555555555555555555#################################################################################
#########################################55555555555555555555555555555555555555#################################################################################
################################################################################################################################################################
#################################################......p#.......#.......#......#################################################################################
#################################################.#############.#.......#......#################################################################################
#################################################.......#.......#.......#......#################################################################################
#######################################################.#.#######.......#......#################################################################################
#################################################.......#.......#.......#......#################################################################################
#################################################.#############.#.......#......#################################################################################
#################################################.......#.......#.......#......#################################################################################
#######################################################.#.#######.......#......#################################################################################
#################################################.......#.......#.......#......#################################################################################
#################################################.#############.#.......#......#################################################################################
#################################################.......#.......#.......#......#################################################################################
#######################################################.#.#######.......#......#################################################################################
#################################################.......#.......#.......#......#################################################################################
#################################################.#############.#.......#......#################################################################################
#################################################.......#.......#.......#......#################################################################################
#######################################################.#.#######.......#......##.............................................................................##
##.............................................................................####............................................................................#
##.............................................................................####............................................................................#
##.............................................................................####............................................................................#
##.............................................................................####............................................................................#
#########################################.......#.......#.......#.......#......#################################################################################
#########################################.......#.#############.#.......#......#################################################################################
#########################################.......#.......#.......#.......#......#################################################################################
#########################################.......#######.#.#######.......#......#################################################################################
#########################################.......#.......#.......#.......#......#################################################################################
#########################################.......#.#############.#.......#......#################################################################################
#########################################.......#.......#.......#.......#......#################################################################################
#########################################.......#######...#######.......#......#################################################################################
################################################################################################################################################################
################################################################################################################################################################
################################################################################################################################################################
################################################################################################################################################################
################################################################################################################################################################
################################################################################################################################################################
################################################################################################################################################################
################################################################################################################################################################
################################################################################################################################################################
################################################################################################################################################################
################################################################################################################################################################
################################################################################################################################################################
