########################################
#.........................#555555555555#
#.........................#555555555555#
#.........................#555555555555#
#.........................#555555555555#
#.........................#555555555555#
#.........................##############
#..............................#.#.....#
#..............................#.#.....#
#..............................#.#.....#
#..............................#.#.....#
#..............................#.#.....#
#...p.............gggggggggggggg.gggggg#
#..................########............#
#gggggggg..........########............#
#########g..........#######............#
##########g..........######............#
###########g............###............#
############g............###############
#############g.............#############
##############g..............###########
###############g...............#########
################g................#######
#################................#######
##################g...............######
###################g...............#####
####################g...............####
#####################g.................#
######################g................#
#######################gggggggggggggggg#