########################################
#.........................#555555555555#
#.........................#555555555555#
#.........................#555555555555#
#.........................#555555555555#
#.........................#555555555555#
#.........................##############
#..............................#.#.....#
#..............................#.#.....#
#..............................#.#.....#
#..............................#.#.....#
#..............................#.#.....#
#...p.............gggggggggggggg.gggggg#
#..................########............#
#gggggggg..........########............#
#########g..........#######............#
##########s..........######............#
###########.............###............#
##########...............###############
##########.................#############
##########...................###########
##########....#g...............#########
##########.sss##g................#######
##########5sss###................#######
##################g...............######
###################g...............#####
####################g...............####
#####################g.................#
######################g................#
#######################gggggggggggggggg#