#########################################55555555555555555555555555555555555555#
#55555555555555555555555555555555#p#.####55555555555555555555555555555555555555#
#########################################55555555555555555555555555555555555555#
####################################5####55555555555555555555555555555555555555#
####################################5####55555555555555555555555555555555555555#
####################################5####55555555555555555555555555555555555555#
####################################5555#55555555555555555555555555555555555555#
#########################################55555555555555555555555555555555555555#
#####################################55##55555555555555555555555555555555555555#
#####################################55#########################################
#########################################.......#.......#.......#.......#......#
#########################################.......#.......#.......#.......#......#
#########################################.......#.......#.......#.......#......#
#########################################.......#.......#.......#.......#......#
#########################################.......#.......#.......#.......#......#
###...###################################.......#.......#.......#.......#......#
###.#####################################.......#.......#.......#.......#......#
###.#####################################.......#.......#.......#.......#......#
###.............###.##.......############.......#.......#.......#.......#......#
###############.###....#####.############.......#.......#.......#.......#......#
############....############.############.......#.......#.......#.......#......#
############.####........###.############.......#.......#.......#.......#......#
############......##..#..###.####......##.......#.......#.......#.......#......#
####################..#..###.####.####.##.......#.......#.......#.......#......#
####################.###.###.####.#######.......#.......#.......#.......#......#
############################...........##.......#.......#.......#.......#......#
############################...####....##.......#.......#.......#.......#......#
############################..######...##.......#.......#.......#.......#......#
######################################.##.......#.......#.......#.......#......#
################################################################################