########################################
#......................................#
#......................................#
#......................................#
#......................................#
#......................................#
#......................................#
#......................................#
#......................................#
#......................................#
#......................................#
#......................................#
#......................................#
#......................................#
#......................................#
#......................................#
#......................................#
#......................................#
#.............................s........#
#.............................s........#
#.............................#........#
#......................................#
#......................................#
#......................................#
#.........................#............#
#.........................#555555555555#
#.........................#555555555555#
#..................p......#555555555555#
#.........................#555555555555#
########################################