################################################################################################################################################################
#########################################55555555555555555555555555555555555555#################################################################################
#########################################55555555555555555555555555555555555555#################################################################################
#########################################55555555555555555555555555555555555555#################################################################################
#########################################55555555555555555555555555555555555555#################################################################################
#########################################55555555555555555555555555555555555555#################################################################################
#########################################55555555555555555555555555555555555555#################################################################################
#########################################55555555555555555555555555555555555555#################################################################################
#########################################55555555555555555555555555555555555555#################################################################################
#########################################5555555555555555555p555555555555555555#################################################################################
################################################################################################################################################################
#################################################.......................#......#################################################################################
#################################################.......................#......#################################################################################
#################################################.......................#......#################################################################################
#################################################.......................#......#################################################################################
#################################################.......................#......#################################################################################
#################################################.......................#......#################################################################################
#################################################.......................#......#################################################################################
#################################################.......................#......#################################################################################
#################################################.......................#......#################################################################################
#################################################.......................#......#################################################################################
#################################################.......................#......#################################################################################
#################################################.......................#......#################################################################################
#################################################.......................#......#################################################################################
#################################################.......................#......#################################################################################
#################################################.......................#......#################################################################################
#################################################################################.............................................................................##
##.............................................................................####............................................................................#
##.............................................................................####............................................................................#
##.............................................................................####............................................................................#
##.............................................................................####............................................................................#
#########################################.......#.......#.......#.......#......#################################################################################
#########################################.......#.#############.#.......#......#################################################################################
#########################################.......#.......#.......#.......#......#################################################################################
#########################################.......#######.#.#######.......#......#################################################################################
#########################################.......#.......#.......#.......#......#################################################################################
#########################################.......#.#############.#.......#......#################################################################################
#########################################.......#.......#.......#.......#......#################################################################################
#########################################.......#######...#######.......#......#################################################################################
################################################################################################################################################################
################################################################################################################################################################
################################################################################################################################################################
################################################################################################################################################################
################################################################################################################################################################
################################################################################################################################################################
################################################################################################################################################################
################################################################################################################################################################
################################################################################################################################################################
################################################################################################################################################################
################################################################################################################################################################
################################################################################################################################################################
