########################################
#........................#.............#
#........................#.............#
#........................#.............#
#........................#.............#
#........................#.............#
#........................#.............#
#........................#.............#
#........................#.............#
#........................#.............#
#........................#.............#
#........................###############
#........................#..#########..#
#........................#..#########..#
#........................#..#########..#
#........................#..#########..#
#........................#..#########..#
#........................#..#########..#
#........................#..#########..#
#........................#..#########..#
#........................#..#########..#
#........................#..#########..#
#........................#..#########..#
#........................#..#########..#
#........................#..#########..#
#........................#..#########..#
#........................#..#########..#
#...p....................#.............#
#........................#.............#
########################################