########################################
#.............#...............#........#
#.............#...............#........#
#.............#...............#........#
#.............#...............#........#
#.............#...............#........#
#.............#...............#........#
#.............#...............#........#
#.............#...............#........#
#.............#..##############........#
#.............#...............#........#
#.............#...............#........#
#.............#...............#........#
#.............#.........#.....#........#
#.............###########.....#........#
#.............#...............#........#
#.............#...............#........#
#.............#...###.........#........#
#.............#.....##........#........#
#.............#......#######..#........#
#.............#............####........#
#.............#...............#........#
#.............#...............#........#
#.............#...............#........#
#.............#...............#........#
#.............#################........#
#......................................#
#p.....................................#
#......................................#
########################################