########################################
#........................#.............#
#........................#.............#
#........................#.............#
#........................#.............#
#........................#.............#
#........................#.............#
#...............................#......#
#........................#.....##......#
#........................#....###.#....#
#........................#....##..#....#
#........................##.###..####.##
#............................###..###..#
#..p.....................#.....##..##..#
#........................#...#...#.#...#
########.#...............#...###.#.....#
#........##..................###...##..#
#.........##.............#...##........#
#........................#..###.#####..#
#...........##...........#..##..#####..#
#............##..........#.....###.....#
#.............##.............###...##..#
#........................#...##..####..#
#...............##.......#.............#
#.................#......#..#.......#..#
#..................##.......#.####..#..#
#....................##..#..#......##..#
#.....................#.###............#
#......................................#
########################################
#......................................#
#......................................#
#......................................#
#......................................#
#......................................#
#......................................#
#......................................#
#......................................#
#......................................#
#......................................#
#......................................#
#......................................#
#......................................#
#......................................#
#......................................#
#......................................#
#......................................#
#......................................#
#......................................#
#......................................#
#......................................#
#......................................#
#......................................#
#......................................#
#......................................#
#......................................#
#......................................#
#......................................#
#......................................#
#......................................#
#......................................#
#......................................#
#......................................#
########################################