########################################
#......................................#
#......................................#
#......................................#
#......................................#
#......................................#
#......................................#
#......................................#
#......................................#
#......................................#
#......................................#
#......................................#
#...p.............ggggggggggggggggggggg#
#..................#####################
#gggggggg..........#####################
#########g..........####################
##########g..........###################
###########g............################
############g................###########
#############g.................#########
##############g.................########
###############g.................#######
################g.................######
#################g.................#####
##################g................#####
###################g................####
####################g................###
#####################g.................#
######################g................#
#######################gggggggggggggggg#