########################################
#......................##5##5#5###5#5###
#......................##5##5#5###5#5###
#......................##5##5#5###5#5###
#......................##5##5#5###5#5###
#......................#################
#......................##.gg.g.ggg.g.###
#......................##.##.#.###.#.###
#......................##.##.#..#..#.###
#......................##.##.#..#..#.###
#......................##.##########.###
#......................##....####....###
#...p.............ggggggggg#############
#..................########............#
#gggggggg..........########............#
#########g..........#######............#
##########s..........######............#
###########.............###............#
##########...............#############.#
##########.................###########.#
##########...................#########.#
##########....#g...............#######.#
##########.sss##g................#######
##########5sss###................#######
##################g...............######
###################g...............#####
####################g...............####
#####################g.................#
######################g................#
#######################gggggggggggggggg#