#GSR...................................#
#p.....................................#
########################################
####################################.###
#......................................#
#......................................#
#......................................#
#......................................#
#......................................#
#55555555555555555555555555555555555555#
##5555555555555555555555555555555555555#
###555555555555555555555555555555555555#
#####5555555555555555555555555555555555#
#######55555555555555555555555555555555#
######555555555555555555555555555555555#
###...#555555555555555555555555555555#5#
###.####55555555555555555555555555555#5#
###.####################################
###.............###.##.......###########
###############.###....#####.###########
############....############.###########
############.####........###.###########
############......##..#..###.####......#
####################..#..###.####.####.#
####################.###.###.####.######
############################...........#
############################...####....#
############################..######...#
######################################.#
########################################